Name,Volume,Ask Size,Ask Price,Bid Size,Bid Price,Last Price,Shares Matched,Shares Routed
UVXY,3574995,200,16.21,800,16.16,16.16,3522794,52201
VXX,3307234,3000,21.32,3000,21.17,21.16,3231142,76092
ARKG,2002864,50,66.00,3,65.05,65.18,1990452,12412
RSX,1494381,6,30.29,1,28.00,28.36,1481386,12995
ITB,1197728,1000,79.36,2,75.00,78.34,1189862,7866
USMV,735909,40,79.00,15,76.95,77.62,728517,7392
IEFA,626745,0,0.00,12,70.00,75.77,619737,7008
INDA,446827,40,50.88,80,48.56,48.60,441230,5597
VIXY,412385,39,17.38,2238,17.31,17.32,397467,14918
IGV,411925,105,444.00,2,426.00,426.95,401752,10173
EZU,410777,590,52.18,1,49.55,49.63,398789,11988
ECH,340299,10,29.60,15,24.50,28.50,338831,1468
PAVE,320530,30,29.25,310,28.80,28.93,316808,3722
MTUM,301286,1,190.93,20,186.00,187.89,298802,2484
VLUE,263117,2,115.00,2,100.00,106.36,259140,3977
SVXY,221904,200,61.62,11,61.52,61.62,210910,10994
ARKQ,172958,10,85.80,12,82.00,83.83,171248,1710
EFV,161526,261,52.35,8,50.21,51.04,158193,3333
CBOE,148616,1,135.00,7,124.93,126.73,148484,132
RYLD,135034,30,25.54,33,25.35,25.40,130838,4196
QUAL,122831,1,158.00,10,144.00,144.25,119903,2928
JPST,120354,2200,50.58,1400,50.56,50.58,120354,0
GOVT,120021,1,28.49,0,0.00,26.34,118856,1165
ESGV,98175,0,0.00,1,86.80,87.20,95562,2613
HYD,92470,1,63.53,1,60.81,62.29,90595,1875
USHY,85632,4,41.68,6,40.79,40.90,85632,0
REM,78487,192,38.00,35,36.35,36.84,72046,6441
EFAV,74903,0,0.00,2,76.38,76.74,73987,916
MOAT,60101,0,0.00,70,71.00,76.28,58882,1219
ARKX,56697,3,20.20,2,19.95,20.19,56152,545
BBJP,55972,0,0.00,100,14.20,58.00,53750,2222
BBEU,52086,0,0.00,0,0.00,59.21,46765,5321
FLOT,50656,1613,50.75,76,50.72,50.75,50656,0
IDV,49810,20,32.00,500,30.50,30.61,46235,3575
EFG,45958,120,113.02,1,109.00,111.20,43656,2302
VUSB,44414,100,50.04,0,0.00,50.02,39125,5289
XBTF,43536,0,0.00,5,53.34,55.88,30440,13096
NOBL,41716,1,97.75,1,95.55,96.03,41416,300
ICVT,41681,67,104.65,403,99.37,99.69,40981,700
IYZ,35458,0,0.00,1,30.85,31.63,31556,3902
PICK,34633,1,42.99,51,41.00,41.59,34533,100
VNM,34139,4,21.51,89,20.27,20.27,32903,1236
PMAY,30052,0,0.00,0,0.00,30.33,30052,0
BBAX,29237,5,57.67,0,0.00,55.39,24689,4548
FNOV,28917,0,0.00,0,0.00,38.49,24958,3959
PTLC,28912,0,0.00,4,38.00,41.12,28912,0
CNYA,28093,100,48.00,1,40.25,43.69,27393,700
BBCA,27889,0,0.00,5,62.00,67.62,27624,265
IVAL,27579,0,0.00,2,26.55,26.72,17579,10000
IGE,26819,138,38.17,190,25.58,31.39,26101,718
VSGX,26803,2,65.45,5,62.00,63.14,26773,30
PRNT,25702,91,36.00,17,35.40,36.00,25521,181
ACWV,25043,30,120.00,1,106.29,106.44,24618,425
ICSH,24300,200,50.44,1700,50.41,50.42,24300,0
NEAR,22726,200,50.03,308,50.00,50.01,22726,0
IFRA,21995,1,38.90,228,37.00,37.64,19884,2111
SMIN,21908,57,60.16,4,59.51,59.79,21908,0
ITM,20203,4,51.39,50,36.95,51.20,20203,0
HYDB,20196,101,52.00,3,51.09,51.28,19696,500
ITA,18513,1,105.51,1,104.01,104.55,17903,610
COWZ,17861,16,47.97,100,45.55,47.97,17861,0
OILK,16539,200,55.10,2,54.01,54.86,16539,0
GTIP,16194,0,0.00,13,57.11,58.49,15693,501
FGRO,16085,0,0.00,0,0.00,21.50,16085,0
ICF,15991,0,0.00,150,69.00,70.59,15591,400
SLVP,15816,100,16.00,35,13.93,13.94,15816,0
FDG,14866,300,90.00,1,84.00,85.95,14666,200
JMST,14834,0,0.00,1,47.87,51.01,14834,0
IEO,14531,2400,62.66,2500,60.16,61.48,14531,0
BUFD,14379,0,0.00,0,0.00,21.18,14379,0
FRDM,14100,0,0.00,4,32.79,33.63,13500,600
EEMV,14074,302,70.00,2,62.90,63.28,13762,312
HSRT,14004,0,0.00,100,37.00,40.73,14004,0
FLDR,13808,0,0.00,0,0.00,50.70,11708,2100
IYT,12994,50,276.00,2,273.60,275.09,12971,23
IAGG,12417,2,56.00,0,0.00,55.15,11714,703
BBUS,12387,0,0.00,1,78.17,85.42,11987,400
HEFA,12385,0,0.00,0,0.00,35.93,12385,0
VOTE,11945,100,80.00,10,54.54,55.28,11945,0
XJH,11114,0,0.00,0,0.00,39.46,11114,0
FSEP,11068,0,0.00,0,0.00,35.58,11068,0
DNOV,10338,0,0.00,0,0.00,35.03,10338,0
FPRO,10201,0,0.00,0,0.00,25.44,10201,0
FCTR,10128,0,0.00,20,35.10,35.80,10128,0
OGIG,9775,50,57.05,36,53.66,54.19,9070,705
TAIL,9762,10,18.85,10,17.80,17.90,9762,0
ENOR,9660,0,0.00,0,0.00,29.65,8184,1476
OMFL,9191,3,52.00,4,46.00,50.20,9174,17
PAPR,9164,0,0.00,0,0.00,29.19,9164,0
FBCG,9111,30,37.17,29,35.00,35.86,9111,0
IZRL,8904,1,31.85,20,29.00,29.89,8848,56
NUSC,8761,0,0.00,0,0.00,46.20,8761,0
GSEW,8735,0,0.00,100,59.71,71.20,8734,1
ESML,8673,0,0.00,1,1.55,41.42,8673,0
IGHG,8433,0,0.00,0,0.00,74.86,6668,1765
FLV,8317,0,0.00,0,0.00,60.95,7417,900
QSPT,8200,0,0.00,0,0.00,20.80,8200,0
FMAG,7936,0,0.00,0,0.00,25.26,7635,301
FCLD,7910,0,0.00,3,25.35,25.93,7610,300
FPFD,7642,0,0.00,0,0.00,24.99,7218,424
DRSK,7456,0,0.00,0,0.00,29.02,7456,0
BBIN,7452,0,0.00,0,0.00,60.12,7452,0
BUFT,7420,0,0.00,0,0.00,20.11,7420,0
PSMC,7358,0,0.00,0,0.00,13.96,7358,0
FRNW,7158,0,0.00,100,26.77,27.50,6642,516
KNG,7081,0,0.00,25,42.00,56.04,7081,0
CALF,6999,0,0.00,12,41.50,46.68,6999,0
FCPI,6886,0,0.00,0,0.00,33.13,6886,0
EMHY,6665,45,45.44,10,35.00,43.08,6264,401
KOCT,6632,0,0.00,0,0.00,27.84,6632,0
FBCV,6516,0,0.00,0,0.00,29.20,6516,0
DIVB,6497,0,0.00,10,38.51,41.73,6497,0
PAWZ,6456,10,83.87,1,76.00,79.35,6456,0
BUFG,6437,0,0.00,0,0.00,20.24,6437,0
TOKE,6374,50,14.24,50,12.92,13.17,5958,416
MLN,6216,0,0.00,0,0.00,21.64,6216,0
GCOW,5817,330,30.80,0,0.00,30.18,5817,0
LQDI,5814,280,31.33,25,29.19,30.58,5164,650
TMFC,5556,200,45.98,4,43.00,44.09,4856,700
GHYG,5552,0,0.00,0,0.00,49.14,5093,459
EMGF,5530,1000,53.01,0,0.00,51.31,5530,0
EDEN,5529,0,0.00,0,0.00,110.30,5529,0
XSHQ,5226,0,0.00,125,40.30,40.57,5226,0
FDHT,5167,0,0.00,0,0.00,26.09,3244,1923
SMMD,5058,0,0.00,200,49.46,67.84,5058,0
BUYZ,5035,250,52.65,1,36.40,48.09,5035,0
GVI,5003,0,0.00,0,0.00,113.66,5003,0
FDRV,4988,2,29.73,0,0.00,29.53,4788,200
NULV,4942,0,0.00,0,0.00,39.49,4669,273
XJR,4837,0,0.00,0,0.00,42.00,4837,0
NULG,4734,0,0.00,20,67.25,72.84,4734,0
NURE,4701,2,39.40,5,36.00,37.97,4671,30
REGL,4656,0,0.00,20,57.24,73.61,4656,0
MSTB,4603,0,0.00,0,0.00,32.58,4603,0
SMB,4582,0,0.00,1100,8.16,17.88,4582,0
PNOV,4526,0,0.00,0,0.00,30.72,4526,0
CEMB,4514,10,51.66,0,0.00,51.07,4514,0
IQDG,4414,0,0.00,0,0.00,39.47,3414,1000
UAPR,4325,0,0.00,0,0.00,26.11,4325,0
PBUS,4318,0,0.00,2035,47.50,47.62,4318,0
PBND,4140,0,0.00,0,0.00,25.60,4140,0
BBRE,4117,1,118.00,2,99.00,105.29,4117,0
EPRF,4108,0,0.00,10,23.60,23.69,4108,0
QDEC,4058,0,0.00,0,0.00,23.03,4058,0
FJUL,4021,0,0.00,0,0.00,36.20,4021,0
XBOC,3997,0,0.00,0,0.00,25.02,3997,0
LVHI,3971,500,29.95,0,0.00,26.13,3971,0
VFQY,3951,0,0.00,0,0.00,127.82,3951,0
MDEV,3937,0,0.00,0,0.00,25.89,3937,0
NUEM,3757,5,36.00,15,33.00,34.02,3757,0
DAUG,3753,0,0.00,0,0.00,35.04,3753,0
BOSS,3656,10,38.00,0,0.00,35.82,3656,0
BOB,3565,0,0.00,0,0.00,27.80,2930,635
IEHS,3526,0,0.00,150,43.10,43.15,3426,100
SATO,3449,0,0.00,0,0.00,28.52,3449,0
GOAT,3405,0,0.00,0,0.00,39.52,2209,1196
OUSA,3364,7,46.80,2,40.93,44.66,3364,0
VIXM,3277,50,35.00,100,27.77,30.99,3277,0
JCPB,3199,0,0.00,100,50.00,54.24,3199,0
DUSA,3167,10,37.00,10,34.00,35.34,3167,0
BAPR,3093,0,0.00,0,0.00,32.97,3093,0
CEFS,2999,18,21.91,1,20.59,21.71,2999,0
JPHY,2965,0,0.00,1,49.79,51.31,2865,100
SYLD,2965,0,0.00,10,51.52,66.77,2965,0
PJUL,2924,0,0.00,0,0.00,30.61,2924,0
PTMC,2912,0,0.00,0,0.00,36.87,2812,100
VCEB,2850,0,0.00,0,0.00,73.17,2850,0
NUMG,2798,0,0.00,0,0.00,57.50,2798,0
DFND,2763,0,0.00,400,38.00,41.80,2763,0
SMMV,2740,0,0.00,0,0.00,38.76,2740,0
EWUS,2702,0,0.00,200,43.60,46.47,2702,0
NOVZ,2701,0,0.00,0,0.00,33.20,2701,0
FLBL,2664,0,0.00,0,0.00,24.96,2664,0
ACIO,2645,0,0.00,0,0.00,31.90,2645,0
OMFS,2641,0,0.00,1,36.93,43.78,2641,0
SHYD,2600,25,25.41,0,0.00,25.01,2600,0
BSEP,2585,0,0.00,0,0.00,32.99,2185,400
PLTL,2579,0,0.00,0,0.00,27.21,1200,1379
IYJ,2571,3,116.00,1,108.00,110.70,2321,250
SMDV,2518,0,0.00,10,54.67,67.03,2518,0
UNOV,2501,0,0.00,700,14.05,29.38,1401,1100
FFTI,2463,0,0.00,0,0.00,23.80,1113,1350
FFSG,2459,0,0.00,0,0.00,37.96,2459,0
MAGA,2450,0,0.00,3,38.21,38.89,2450,0
DDWM,2421,322,31.49,0,0.00,30.63,2421,0
BNOV,2390,0,0.00,0,0.00,32.50,2090,300
LKOR,2366,2,68.30,1,59.43,59.82,2366,0
JEMA,2353,0,0.00,0,0.00,47.80,2353,0
UMAY,2304,0,0.00,0,0.00,28.70,2304,0
STOT,2300,0,0.00,0,0.00,49.22,1774,526
SVAL,2264,2,34.99,80,31.00,32.89,2263,1
IQM,2224,0,0.00,10,43.50,56.58,1251,973
RULE,2200,0,0.00,0,0.00,25.53,2200,0
PTNQ,2177,0,0.00,100,51.00,59.27,2099,78
QCON,2100,0,0.00,0,0.00,49.60,1500,600
BUFR,2088,0,0.00,0,0.00,23.77,2088,0
HEGD,2049,0,0.00,0,0.00,19.41,2049,0
DFEB,2041,0,0.00,0,0.00,35.04,2041,0
AFIF,2022,0,0.00,1400,7.00,9.54,1922,100
VFMF,1944,0,0.00,1,108.22,108.69,1944,0
PDEC,1925,0,0.00,0,0.00,31.02,1925,0
MFUL,1909,0,0.00,0,0.00,24.81,1909,0
EFAD,1865,0,0.00,0,0.00,47.00,1865,0
IMOM,1855,0,0.00,0,0.00,35.05,1855,0
FFEB,1835,0,0.00,0,0.00,38.02,1835,0
XVV,1833,0,0.00,16,31.83,36.20,1833,0
RSXJ,1828,1,41.03,100,35.05,35.98,1828,0
QVAL,1806,0,0.00,1,34.50,38.88,1806,0
IGRO,1791,2,72.00,300,33.17,67.01,1791,0
EFNL,1781,24,54.95,0,0.00,47.21,1781,0
ESG,1728,7,216.09,100,110.00,114.85,1728,0
IEIH,1727,1,38.00,0,0.00,34.86,1727,0
BUFF,1714,0,0.00,0,0.00,35.71,1714,0
MBCC,1673,0,0.00,0,0.00,29.66,1673,0
ESGG,1659,1,158.00,1,145.00,150.87,1659,0
MFMS,1604,0,0.00,200,34.00,38.26,1604,0
AUGZ,1600,0,0.00,0,0.00,33.25,1600,0
ATMP,1588,0,0.00,0,0.00,16.06,1588,0
DFNL,1578,2,33.88,0,0.00,31.73,1578,0
JPIB,1573,0,0.00,0,0.00,50.73,1573,0
DWLD,1571,1,50.00,0,0.00,30.70,1571,0
IEDI,1569,0,0.00,2,46.12,48.58,1569,0
BMAY,1558,0,0.00,0,0.00,32.84,1558,0
OCTZ,1533,0,0.00,0,0.00,32.55,1533,0
IBHB,1527,0,0.00,0,0.00,24.18,1527,0
MOTI,1526,0,0.00,0,0.00,34.00,1526,0
SULR,1523,0,0.00,0,0.00,34.98,1423,100
XMPT,1504,8,30.37,10000,1.00,29.25,1504,0
DINT,1493,0,0.00,35,19.90,20.56,1493,0
EMDV,1471,0,0.00,0,0.00,57.43,1471,0
FMIL,1464,0,0.00,0,0.00,29.48,1464,0
OEUR,1458,100,29.95,4,26.38,28.76,1448,10
TDV,1442,2,72.00,2,62.37,64.68,1442,0
DSEP,1436,0,0.00,0,0.00,33.02,1436,0
FSMO,1435,0,0.00,0,0.00,24.75,1435,0
VFVA,1428,0,0.00,2,103.00,105.35,1428,0
PEX,1421,100,38.50,0,0.00,37.40,1421,0
PSEP,1404,0,0.00,0,0.00,30.11,1104,300
QJUN,1337,0,0.00,0,0.00,21.36,1337,0
ALFA,1311,0,0.00,0,0.00,84.96,499,812
IYLD,1298,0,0.00,12,22.36,23.76,1298,0
NJUL,1292,0,0.00,0,0.00,47.92,1237,55
IAUF,1287,10,59.37,1,53.80,55.12,1287,0
VFMO,1285,0,0.00,2,128.00,138.02,1285,0
FMAY,1279,0,0.00,0,0.00,37.87,1279,0
PBSM,1278,0,0.00,0,0.00,40.72,1278,0
DFHY,1276,0,0.00,0,0.00,24.49,939,337
FOCT,1276,0,0.00,0,0.00,35.28,1276,0
IBHD,1269,0,0.00,0,0.00,24.47,1204,65
YSEP,1252,0,0.00,0,0.00,19.96,1168,84
DJAN,1245,0,0.00,0,0.00,32.19,1245,0
DDLS,1236,0,0.00,0,0.00,35.04,1236,0
DALT,1220,0,0.00,0,0.00,10.71,1220,0
OUSM,1220,0,0.00,5,35.00,37.15,1220,0
AGT,1211,0,0.00,0,0.00,26.95,611,600
IGEB,1189,0,0.00,0,0.00,53.16,961,228
FDEC,1133,0,0.00,0,0.00,34.20,1133,0
IETC,1130,100,66.00,3,60.00,61.42,1130,0
SECT,1094,0,0.00,0,0.00,44.41,1094,0
KJUL,1082,0,0.00,0,0.00,26.73,1082,0
EGIS,1071,0,0.00,68,29.50,35.17,1071,0
WUGI,1071,0,0.00,11,62.00,66.80,771,300
NUDM,1045,0,0.00,0,0.00,32.30,938,107
FAUG,1036,0,0.00,0,0.00,38.20,1036,0
FLQL,1033,0,0.00,10,33.00,45.70,1033,0
IBMN,1008,0,0.00,0,0.00,27.87,1008,0
PSCW,1000,0,0.00,0,0.00,21.91,1000,0
FYLD,973,103,30.19,1,26.75,27.00,973,0
DJUL,966,0,0.00,0,0.00,33.42,966,0
DUDE,964,1,36.00,0,0.00,30.15,964,0
PAUG,962,0,0.00,0,0.00,30.15,962,0
IVRA,958,0,0.00,20,13.00,14.95,958,0
SHAG,942,0,0.00,0,0.00,50.54,942,0
FLHY,924,0,0.00,0,0.00,26.09,924,0
BJUL,923,0,0.00,0,0.00,32.95,923,0
PFEB,909,0,0.00,0,0.00,29.10,909,0
YPS,902,0,0.00,0,0.00,24.34,802,100
LIV,901,0,0.00,0,0.00,28.78,901,0
DMAR,900,0,0.00,0,0.00,31.73,900,0
FJAN,900,0,0.00,0,0.00,33.98,900,0
RESE,896,0,0.00,0,0.00,35.97,596,300
IECS,868,0,0.00,500,32.00,33.01,868,0
POCT,854,0,0.00,10,29.24,30.25,554,300
TMAT,849,0,0.00,0,0.00,22.68,849,0
IEFN,820,0,0.00,0,0.00,33.70,820,0
EYLD,803,0,0.00,1,35.00,35.04,803,0
MINN,800,0,0.00,0,0.00,25.03,800,0
NUMV,798,0,0.00,50,35.00,38.92,798,0
FFTG,768,0,0.00,0,0.00,30.58,768,0
HCRB,750,0,0.00,0,0.00,40.82,750,0
IBMM,726,0,0.00,0,0.00,26.83,726,0
OSCV,725,0,0.00,0,0.00,35.47,725,0
PJAN,723,0,0.00,0,0.00,33.15,723,0
AESR,718,0,0.00,0,0.00,14.79,718,0
IDME,705,0,0.00,0,0.00,24.74,705,0
DFNV,704,0,0.00,0,0.00,30.48,704,0
DAPR,700,0,0.00,0,0.00,31.38,700,0
YMAR,700,0,0.00,0,0.00,20.94,700,0
FFHG,697,0,0.00,10,37.03,37.71,697,0
ADME,669,0,0.00,0,0.00,42.36,669,0
PTEU,661,0,0.00,0,0.00,25.01,661,0
PSMG,657,0,0.00,103,17.91,19.08,557,100
LYFE,656,0,0.00,100,30.00,33.03,656,0
PJUN,623,0,0.00,0,0.00,32.00,623,0
GOVZ,613,0,0.00,0,0.00,21.86,613,0
PSMR,611,0,0.00,0,0.00,22.09,611,0
EAOA,608,0,0.00,0,0.00,34.49,608,0
GVAL,608,5,26.00,1,22.88,22.97,608,0
MSMR,600,0,0.00,0,0.00,24.99,600,0
PSCJ,600,0,0.00,0,0.00,21.13,600,0
TTAC,576,0,0.00,0,0.00,58.62,476,100
FJUN,565,0,0.00,0,0.00,37.53,565,0
BJAN,556,0,0.00,0,0.00,37.05,556,0
LUXE,536,0,0.00,5,30.90,32.66,536,0
LEAD,534,0,0.00,0,0.00,59.82,534,0
WDNA,525,100,27.69,4,24.51,24.75,525,0
FDEM,524,0,0.00,0,0.00,26.00,524,0
CSM,523,0,0.00,0,0.00,108.90,523,0
ADFI,517,0,0.00,1400,7.00,9.58,517,0
ICOW,516,0,0.00,0,0.00,31.04,516,0
HELX,508,0,0.00,3,45.51,49.94,508,0
IDHD,508,0,0.00,0,0.00,26.98,508,0
TFJL,502,0,0.00,0,0.00,23.60,502,0
UJUN,501,0,0.00,0,0.00,29.22,501,0
MSVX,500,0,0.00,0,0.00,24.78,500,0
FDEV,495,0,0.00,700,14.65,29.60,495,0
BJUN,488,0,0.00,0,0.00,34.19,488,0
AVDR,485,0,0.00,0,0.00,31.90,485,0
TRTY,465,0,0.00,900,24.60,28.13,465,0
IBHG,460,0,0.00,0,0.00,24.77,460,0
EWGS,453,0,0.00,13,80.00,81.00,453,0
HYXU,453,0,0.00,0,0.00,53.37,453,0
FLQM,425,0,0.00,0,0.00,47.78,425,0
FIBR,423,0,0.00,0,0.00,99.37,423,0
BFEB,420,0,0.00,0,0.00,31.83,420,0
ESHY,415,0,0.00,0,0.00,20.89,415,0
HYIN,414,0,0.00,1,1.00,25.31,414,0
PSMB,413,0,0.00,0,0.00,17.16,413,0
PSMM,407,0,0.00,0,0.00,15.85,407,0
JMUB,401,0,0.00,0,0.00,54.96,401,0
DBOC,400,0,0.00,0,0.00,30.04,400,0
GSUS,400,0,0.00,0,0.00,64.97,400,0
PBTP,395,0,0.00,0,0.00,26.76,395,0
ZECP,385,0,0.00,0,0.00,26.16,385,0
QPFF,384,0,0.00,0,0.00,41.05,384,0
BLKC,372,300,100.00,4,24.00,27.40,372,0
GMOM,371,0,0.00,0,0.00,30.66,371,0
PBEE,371,0,0.00,0,0.00,28.27,371,0
SPMV,371,0,0.00,0,0.00,39.96,371,0
UAUG,357,0,0.00,0,0.00,29.18,357,0
GAA,351,0,0.00,200,30.08,31.90,351,0
WFHY,334,0,0.00,5,48.82,51.93,334,0
VXZ,331,500,28.00,78,25.95,26.10,108,223
VFMV,320,0,0.00,100,95.98,103.36,320,0
IBHE,304,0,0.00,0,0.00,24.86,304,0
IBHC,301,0,0.00,0,0.00,24.46,301,0
IVLC,301,0,0.00,0,0.00,15.09,301,0
EOPS,287,0,0.00,0,0.00,28.01,287,0
IEME,279,0,0.00,11,34.35,34.52,278,1
BBSA,277,0,0.00,0,0.00,51.06,277,0
DMAY,260,0,0.00,0,0.00,34.48,260,0
IVSG,259,0,0.00,0,0.00,14.49,259,0
BALT,254,0,0.00,0,0.00,25.88,254,0
FOMO,253,1,27.00,5,24.24,25.19,253,0
TYA,245,0,0.00,10,24.08,24.08,245,0
EUDV,241,0,0.00,0,0.00,54.01,241,0
USMF,235,0,0.00,0,0.00,41.06,235,0
PSCX,234,0,0.00,0,0.00,22.27,234,0
EMTL,230,0,0.00,0,0.00,49.83,230,0
DURA,223,0,0.00,0,0.00,31.21,223,0
TILT,217,0,0.00,1,170.00,182.40,217,0
AVDG,211,0,0.00,5,32.00,32.92,211,0
MAAX,210,0,0.00,0,0.00,24.80,210,0
EAOR,207,0,0.00,0,0.00,31.76,207,0
PSMJ,206,0,0.00,0,0.00,21.18,206,0
GLDB,203,0,0.00,0,0.00,24.16,203,0
BLDG,202,0,0.00,200,30.81,32.89,202,0
NULC,201,0,0.00,4,41.00,43.66,101,100
DDEC,200,0,0.00,0,0.00,32.40,200,0
EMSH,200,0,0.00,0,0.00,72.12,200,0
FMAR,200,0,0.00,0,0.00,32.96,200,0
NUDV,200,0,0.00,100,24.78,26.04,200,0
UDEC,200,0,0.00,0,0.00,29.83,200,0
UOCT,200,0,0.00,100,27.86,28.39,200,0
QMOM,195,0,0.00,0,0.00,54.72,195,0
TTAI,190,0,0.00,0,0.00,36.83,190,0
FAPR,188,0,0.00,0,0.00,32.28,147,41
BDEC,175,0,0.00,0,0.00,34.12,175,0
XDAT,169,0,0.00,0,0.00,28.90,169,0
HEEM,168,0,0.00,0,0.00,30.71,68,100
QLC,168,0,0.00,0,0.00,51.01,168,0
GSST,167,0,0.00,0,0.00,50.57,167,0
BGLD,156,0,0.00,0,0.00,18.97,156,0
VFLQ,155,0,0.00,1,115.00,116.29,155,0
PMAR,140,0,0.00,0,0.00,31.31,140,0
SLT,118,0,0.00,0,0.00,44.23,118,0
STLG,118,0,0.00,0,0.00,40.64,118,0
EUCG,115,0,0.00,0,0.00,27.75,115,0
MEAR,115,0,0.00,100,47.50,50.13,115,0
TCTL,112,0,0.00,0,0.00,34.41,112,0
ACSI,111,0,0.00,0,0.00,53.45,111,0
MRSK,110,0,0.00,0,0.00,33.15,110,0
PSFM,109,0,0.00,0,0.00,22.93,109,0
PSFF,108,0,0.00,0,0.00,22.70,108,0
KNGS,103,0,0.00,100,27.00,28.82,63,40
TSJA,103,0,0.00,0,0.00,29.61,103,0
PWS,102,0,0.00,5,33.00,34.58,102,0
XTOC,102,0,0.00,0,0.00,25.55,102,0
FLQS,101,0,0.00,0,0.00,41.35,101,0
DSJA,100,0,0.00,0,0.00,30.00,100,0
IBMQ,100,0,0.00,0,0.00,27.16,100,0
IGLD,100,0,0.00,0,0.00,20.23,100,0
IMLP,100,0,0.00,0,0.00,12.84,100,0
KAPR,100,0,0.00,0,0.00,28.09,100,0
KJAN,100,0,0.00,0,0.00,31.98,100,0
MRGR,100,0,0.00,0,0.00,41.64,100,0
NOCT,100,0,0.00,0,0.00,40.56,51,49
PSMO,100,0,0.00,0,0.00,21.04,100,0
UJAN,100,0,0.00,0,0.00,31.49,100,0
IVDG,92,0,0.00,20,12.00,14.09,92,0
HYHG,91,0,0.00,0,0.00,62.68,91,0
ALTS,80,0,0.00,0,0.00,39.08,80,0
IMFL,75,0,0.00,0,0.00,26.28,75,0
CBTG,73,0,0.00,0,0.00,20.60,73,0
VMOT,71,0,0.00,0,0.00,28.10,71,0
MAMB,60,0,0.00,0,0.00,25.18,60,0
NJAN,54,0,0.00,0,0.00,42.21,54,0
FEDX,51,0,0.00,1,22.69,28.14,51,0
ISVL,48,0,0.00,0,0.00,36.60,48,0
QTOC,37,0,0.00,0,0.00,26.24,37,0
VWID,34,0,0.00,0,0.00,28.53,34,0
MAYZ,28,0,0.00,0,0.00,27.26,28,0
XSHD,27,0,0.00,0,0.00,22.65,27,0
FAIL,26,100,23.00,30,21.60,21.73,26,0
WIL,26,0,0.00,300,40.05,99.36,26,0
MPRO,24,0,0.00,0,0.00,27.20,24,0
MOTE,22,0,0.00,0,0.00,27.25,22,0
APXH,20,0,0.00,0,0.00,10.08,20,0
VAMO,20,0,0.00,200,24.66,26.82,20,0
XBAP,19,0,0.00,0,0.00,27.16,19,0
NAPR,16,0,0.00,0,0.00,38.64,16,0
IBHF,15,0,0.00,0,0.00,25.27,15,0
IBML,12,0,0.00,98,25.90,25.95,12,0
SMI,9,0,0.00,0,0.00,49.89,9,0
HFGO,7,0,0.00,0,0.00,19.77,7,0
SFIG,7,0,0.00,0,0.00,50.85,7,0
ARCM,5,0,0.00,0,0.00,99.88,5,0
ESEB,5,0,0.00,0,0.00,21.00,5,0
QTAP,5,0,0.00,0,0.00,29.87,5,0
ROMO,5,0,0.00,0,0.00,29.87,5,0
VIRS,5,0,0.00,500,14.71,35.15,5,0
KWT,4,0,0.00,0,0.00,35.87,4,0
PXUS,4,0,0.00,0,0.00,25.35,4,0
TSOC,4,0,0.00,25,30.33,32.26,4,0
HYMU,3,0,0.00,0,0.00,26.35,3,0
IBHA,3,0,0.00,0,0.00,24.10,3,0
WFIG,3,0,0.00,0,0.00,53.69,3,0
EAOM,2,0,0.00,0,0.00,29.15,2,0
GSEE,2,0,0.00,0,0.00,52.52,2,0
GSID,2,0,0.00,0,0.00,56.60,2,0
JUNZ,2,0,0.00,0,0.00,27.32,2,0
XDQQ,2,0,0.00,0,0.00,30.28,2,0
IBMO,1,0,0.00,0,0.00,26.80,1,0
MIG,1,0,0.00,0,0.00,24.75,1,0
PBDM,1,0,0.00,0,0.00,29.66,1,0
QMAR,1,0,0.00,0,0.00,22.57,1,0
RESD,1,0,0.00,10,21.48,31.24,1,0
TMDV,1,0,0.00,0,0.00,49.16,1,0
XTAP,1,0,0.00,0,0.00,28.45,1,0
AMER,0,0,0.00,0,0.00,0.00,0,0
APRZ,0,0,0.00,0,0.00,0.00,0,0
BAUG,0,0,0.00,0,0.00,0.00,0,0
BMAR,0,0,0.00,1,7.27,0.00,0,0
BOCT,0,0,0.00,0,0.00,0.00,0,0
CFCV,0,0,0.00,0,0.00,0.00,0,0
DBJA,0,0,0.00,0,0.00,0.00,0,0
DECZ,0,0,0.00,0,0.00,0.00,0,0
DJUN,0,0,0.00,0,0.00,0.00,0,0
DOCT,0,0,0.00,100,32.00,0.00,0,0
DSOC,0,0,0.00,0,0.00,0.00,0,0
EAOK,0,0,0.00,0,0.00,0.00,0,0
ESCR,0,0,0.00,0,0.00,0.00,0,0
EURZ,0,0,0.00,0,0.00,0.00,0,0
FEBZ,0,0,0.00,0,0.00,0.00,0,0
FLIA,0,0,0.00,0,0.00,0.00,0,0
FUNL,0,0,0.00,0,0.00,0.00,0,0
FUT,0,0,0.00,0,0.00,0.00,0,0
GHTA,0,0,0.00,0,0.00,0.00,0,0
HEET,0,0,0.00,0,0.00,0.00,0,0
HSUN,0,0,0.00,0,0.00,0.00,0,0
IBMP,0,0,0.00,0,0.00,0.00,0,0
JANZ,0,0,0.00,0,0.00,0.00,0,0
JULZ,0,0,0.00,0,0.00,0.00,0,0
LSLT,0,0,0.00,0,0.00,0.00,0,0
MARZ,0,0,0.00,0,0.00,0.00,0,0
MBBB,0,0,0.00,0,0.00,0.00,0,0
MBND,0,0,0.00,0,0.00,0.00,0,0
MOHR,0,0,0.00,0,0.00,0.00,0,0
OBND,0,0,0.00,0,0.00,0.00,0,0
PLRG,0,0,0.00,0,0.00,0.00,0,0
PSCQ,0,0,0.00,0,0.00,0.00,0,0
PSFD,0,0,0.00,0,0.00,0.00,0,0
PSFJ,0,0,0.00,0,0.00,0.00,0,0
PSFO,0,0,0.00,0,0.00,0.00,0,0
PSMD,0,0,0.00,0,0.00,0.00,0,0
QTJL,0,0,0.00,0,0.00,0.00,0,0
RDFI,0,0,0.00,0,0.00,0.00,0,0
REC,0,0,0.00,0,0.00,0.00,0,0
RODE,0,0,0.00,0,0.00,0.00,0,0
RODI,0,0,0.00,0,0.00,0.00,0,0
RTAI,0,0,0.00,0,0.00,0.00,0,0
SEPZ,0,0,0.00,0,0.00,0.00,0,0
STLV,0,0,0.00,0,0.00,0.00,0,0
TBJL,0,0,0.00,0,0.00,0.00,0,0
TEGS,0,0,0.00,0,0.00,0.00,0,0
THY,0,0,0.00,0,0.00,0.00,0,0
UFEB,0,0,0.00,0,0.00,0.00,0,0
UJUL,0,0,0.00,0,0.00,0.00,0,0
UMAR,0,0,0.00,0,0.00,0.00,0,0
USEP,0,0,0.00,0,0.00,0.00,0,0
USEQ,0,0,0.00,0,0.00,0.00,0,0
WLDR,0,0,0.00,0,0.00,0.00,0,0
XBJL,0,0,0.00,0,0.00,0.00,0,0
XDAP,0,0,0.00,0,0.00,0.00,0,0
XDJL,0,0,0.00,0,0.00,0.00,0,0
XDOC,0,0,0.00,0,0.00,0.00,0,0
XDSQ,0,0,0.00,0,0.00,0.00,0,0
XJUN,0,0,0.00,0,0.00,0.00,0,0
XTJL,0,0,0.00,0,0.00,0.00,0,0
YDEC,0,0,0.00,0,0.00,0.00,0,0
YJUN,0,0,0.00,0,0.00,0.00,0,0